########################################
#......................................#
#..#####...............................#
#..#...#...............................#
#..#...#...............................#
#..#####..................######.......#
#........................#......#......#
#........................#......#......#
#........................######.#......#
#..............................#.#.....#
#..............................#.#.....#
#..............................###.....#
#......................................#
#......................................#
#......................................#
#......................................#
########################################