#################################################################################################
#  │         x      │                                                                           #
#  │                │                              ~~~~~~#                                      #
#  │                │      ~~~~#                                #~~~~~~                         #
#  │   o            │                               ~~~~                                        #
#  │                │                ~~~~#                                                      #
#  │       °        │                                                                           #
#  │   °            │                                        °                                  #
#  │    °           ╰──────────────────────────────────────────────────────────────────────────╮#
#  │               x                                                                           │#
#  │                                                         °                 x               │#
#  │                        °                                                                  │#
#  │        o                 °                                                                │#
#  │                                            °                                              │#
#  │                 O                                        O                                │#
#  │                               o                                                           │#
#  │   ^                                                                     o                 │#
#  │                                                    °                  o             o     │#
#  │                     ╭────────────────────╮                     o                          │#
#  │          °          │                    │          °                                     │#
#  │   o                 │     xx             │                                                │#
#  │                     │           xx       │                 ^             x                │#
#  │        o            │                    │   O                                            │#
#  │                     │                    │                                                │#
#  │                     │     _-_            │                                      °         │#
#  │                     │                    │            ~~~~#                               │#
#  │            o        │                    │                                                |#
#  │                     │         °          │                     °                          |#
#  │       °             │                    │                                         °      │#
#  │                     │                    │  o                                             │#
#  │  ^                  │   O                │                                ^               │#
#  │                     │                    │                     x                          │#
#  │              o      │                    │                                                │#
#  ╰─────────────────────╯                    ╰────────────────────────────────────────────────╯#
#################################################################################################