########################################
#......................................#
#.............#####....................#
#.............#...#....................#
#.....####....#...#....................#
#.....#..#....#...#....................#
#.....#..#....#####......######........#
#.....####....................#........#
#.............................#........#
#.............######..........#........#
#.............#....#..........#........#
#.............#....#..........######...#
#.............#....#...................#
#.............######...................#
#......................................#
#......................................#
########################################