#########################################################################################################################################
#                                                                                                                                       #
#                                                                                                                                       #
#                                                                                                                                       #
#                                                                                                                                       #
#                                                                                                                                       #
#                                                                                                                                       #
#                                                                                                                                       #
#                                                                                                                                       #
#                                                                                                                                       #
#                                                                                                                                       #
#                                                                                                                                       #
#                                                                                                                                       #
#                                                                                                                                       #
#                                                                                                                                       #
#                                                                                                                                       #
#                                                                                                                                       #
#                                                                                                                                       #
#                                                                                                                                       #
#                                                                                                                                       #
#                                                                                                                                       #
#                                                                                                                                       #
#                                                                                                                                       #
#                                                                                                                                       #
#                                                                                                                     ────────── #
#                                                                                                                                       #
#                                                                                                                                       #
#                                                                                                                                       #
#                                                                                                                                       #
#                                                                                                                                       #
#                                                                                                                                       #
#                                                                                                                                       #
#                                                                                                                                       #
#                                                                                                                                       #
#                                                                                                                                       #
#                                                                                                                                       #
#                                                                                                                                       #
#                                                                                                                                       #
#                                                                                                                                       #
#                                                                                                                                       #
#                                                                                                                                       #
#                                                                                                                                       #
#                                                                                                                                       #
#                                                                                                                                       #
#                                                                                                                                       #
#                                                                                                                                       #
#                                                                                                                                       #
#                                                                                                                                       #
#                                                                                                                                       #
#                                                                                                                                       #
#                                                                                                                                       #
#                                                                                                                                       #
#                                                                                                                                       #
#                                                                                                                                       #
#########################################################################################################################################