########################################
#......................................#
#....####....................####......#
#....#..#....................#..#......#
#....#..#........####........#..#......#
#....####........#..#........####......#
#................#..#..................#
#................####..................#
#......................................#
#..........###########.................#
#..........#.........#.................#
#..........#.........#.................#
#..........#.........#.................#
#..........###########.................#
#......................................#
#......................................#
########################################