########################################
#                                      #
#             #####                    #
#             #...#                    #
#     ####    #...#                    #
#     #..#    #...#                    #
#     #..#    #####      ######        #
#     ####                    #        #
#                             #        #
#             ######          #        #
#             #....#          #        #
#             #....#          ######   #
#             #....#                   #
#             ######                   #
#                                      #
#                                      #
########################################