##################################################################################
#           │               ~~~~~~~~~~~~~~~~~~~~~~~~~~~              │           #
#           │        ~~~~~~~                          ~~~~~~~        │           #
#───────────╯~~~~~~~~                                        ~~~~~~~~╰───────────#
#                                                                                #
#                                                                                #
#                                                                                #
#                                                                                #
#───────────╮                                                       ╭────────────#
#           │                                                       │            #
#           │                                                       │            #
#           │          °    |                       |               │            #
#      o    │                                                       │            #
#     \|/   │               |                       |               │  o         #
#     / \   │    O                                                  │ \|/        #
#           │                                           O      °    │ / \        #
#           │               |                       |               │            #
#           │      °                                                │            #
#           │                                            x          │            #
#    ___    |               |                       |               │            #
#   / = \   │               |                       |               │            #
#  /_____\  │                                                       │            #
#  |     |  │         °                                 O           │     o      #
#  |     |  │                                                       │    \|/     #
#           │               |                       |    X   °      │    / \     #
#           │  x                                                    │            #
#           │                                                       │            #
#           │                                                       │ o          #
#           │               |                       |               │\|/         #
#     o     │          O                                            │/ \         #
#    \|/    │                                                       │            #
#    / \    │   X                                                   │            #
#           │                                                       │            #
#           │     °         |                       |               │    ____    #
#           │               |                       |               │   / oo \   #
#           │                                                  °    │  /______\  #
#           │                                                       │  |      |  #
#   o       │                                                       │  |      |  #
#  \|/      │  °            |                       |     X         │            #
#  / \      │                                                       │            #
#           │               |                       |               │            #
#    ___    │         O                                             │       o    #
#   / + \   │                                                       │      \|/   #
#  /_____\  │    X                                                  │      / \   #
#  │     │  │               |                       |               │            #
#  │     │  │                                              O        │            #
#           │       °                                               |            #
#           │      °        |                       |               │            #
#           │                                                       │            #
##################################################################################