########################################
#......................................#
#.............#####....................#
#.............#...#....................#
#.............#...#....................#
#.............#####....................#
#......................................#
#.............######..........#####....#
#.............#....#..........#...#....#
#.............#....#..........#...#....#
#.............#....#..........#...#....#
#.............######..........#####....#
#......................................#
#......................................#
#......................................#
#......................................#
########################################