##########################################################################################################################################
#                                                                                                                                        #
#        *                                                                                                                               #
#                                                                                                       *                                #
#                     °                                                       [x]                                                        #
#                                                                                                                                        #
#                                                                                                                                        #
#                    [x]                °                                                                                                #
#                                                                                                                                        #
#                                                                                                                                        #
#        °                                                                                                        [x]                    #
#                                                                              *                                                         #
#────────────────│                                │──────────────────────────────────────────────────────────────────────────────────────#
#                │      --                  --    │                                                                                      #
#                O      --                        O                                                                                      #
#                │                --              │                                                                                      #
#                │                                │                                                                                      #
#                O                         --     O                                                                                      #
#                │     --      --                 │                                     ╭────────────────────────────────────────────────#
#                │                                │                                     │                                                #
#                O                      --        O                                     │      [x]                                       #
#                │                 --             │                                     │                   °                            #
#                │        --                      │                                     │                                                #
#                O                       --       O                                     │                                                #
#                │    --            --            │                                     │                                                #
#                │                                │                                     │                                                #
#                O                    --          O                                     │                                                #
#                │             --                 │                                     │                                                #
#                │     --                   --    │                                     │                                                #
#────────────────│                                │─────────────────────────────────────╯                            °                   #
#                                                                                                                                        #
#                                                                                                                              [x]       #
#      [x]                                                               °                                                               #
#                                                                                                     °                                  #
#                                °                                                                                                       #
#                                                                 *                                                                      #
#                                                                                                                                        #
#                                                                                                                                        #
#                *                   [x]                                                                                                 #
#                                                                                          [x]                                           #
#                                                                                                            °                           #
#                                                                                                                                        #
#                                                                                                                                        #
#       [x]                    °                                                                                                  °      #
#                                                                                                                                        #
#                                                              ╭─────────────────────────────────────────────────────────────────────────#
#                                                   °          │                                                                         #
#                                                              │                                                                         #
#                                                              │                                                                         #
#                     *                                        │                                                                         #
#                                         [x]                  │                                                                         #
#                                                              │                                                                         #
#                                                              │                                                                         #
##########################################################################################################################################